..........X.........
.......######.......
..B..............D..
####..G.G.G.G...####
.......G.A.GCG......
......--------......
....-...........-...
....................
.G.G............A.G.
####.........#######
....................
.1........C....A....
####################