..........X.........
.......######.......
..P..............C..
####..G.G.G.G....###
.......G.G.GCG......
......--------......
....-...........-...
....................
.G.G............C.G.
####............####
....................
.1........C.........
####################